╭────╮
│    ║
╰────╯           
               ╭───────────────╮
 ╭────╮        │               │
 │    ║       ╭╯   ╭─╮         │
 ╰────╯       │   ╭╯ ╰─────────╯
╭─────────────╯   ╰────────────╮
│                              │
│                              │
│                              │
│                              ║
│                              ║
│                              │
│                              │
│                              │
╰──────────────────────────────╯
